delicacy : изысканный
pests : паразиты
source : источник
contamination : загрязнение 
dough : тесто 
fraction : частица
edible : съедобный
digestible : усваиваемый 
generous : щедрый 
add : добавить
chop : рубить
break : разорвать
peel : очищать
pour : наливать
slice : нарезать
stir : мешать
grate : натерать
cut : резать
beat : отбивать
crockery : посуда
cutlery : столовые приборы
chopping board : разделочная доска
ladle : поварешка
oven : духовка
pan : кастрюля
pot : горшок
sieve : сито
spatula : лопатка
tablespoon : столовая ложка
pinch : щепотка
handful : горстка
cup : кружка
tin : банка
drain : истощать
garnish : украсить
shred : шинковать
soak : впитывать
bring : приносить
simmer : закипать
blend : смешивать
appetiser :  закуска
beverage : напиток
receipt : чек
recipe : рецепт
